по	PREP
послїднїм	ADJ
розпадї	ADV
ґрупы	NOUN
The	X
Yardbirds	X
7	NUM
юла	NOUN
1968	NUM
року	NOUN
ґітаріста	NOUN
джіммі	NAME
пейдж	NAME
мусив	ADV
зробити	VERB
нове	ADJ
зложіня	ADJ
ґрупы	NOUN
на	PREP
тот	DEF
час	NOUN
ся	PRON
з	PREP
пейджом	NAME
споёвала	VERB
репутація	NOUN
жаданого	ADJ
ґітарісту	NOUN
він	ADV
уж	PART
грав	NOUN
як	PREP
штудіовый	ADJ
музикант	NOUN
у	PREP
такых	ADJ
ґрупах	NOUN
як	CONJ
The	X
Who	X
The	X
Kinks	X
Donovan	X
і	CONJ
богато	ADV
іншых	ADJ
другым	ADJ
до	PREP
нового	ADJ
зложіня	NOUN
быв	VERB
закликаный	ADJ
бас-ґітариста	NOUN
джон	NAME
пол	NAME
джонс	NAME
пейдж	NAME
ся	PRON
з	PREP
ним	PRON
познакомив	VERB
в	PREP
апрілю	NOUN
1968	NUM
року	NOUN
в	PREP
часї	NOUN
роботы	NOUN
у	PREP
donovan	X
в	PREP
літї	NOUN
1968	NUM
року	NOUN
джіммі	NAME
іде	CONJ
до	PREP
бірмінґема	NOUN
послухати	VERB
а	CONJ
може	VERB
і	CONJ
запросити	VERB
молодого	ADJ
вокалісту	NOUN
роберта	NAME
планта	NAME
якый	ADJ
тогды	ADV
співав	VERB
у	PREP
властній	ADJ
ґрупі	NOUN
band	X
of	X
joy	X
плант	NOUN
одразу	NUM
погодився	VERB
і	PREP
теперь	ADV
про	PREP
тріо	NUM
быв	VERB
потрібный	ADJ
бубеник	NOUN
плант	NOUN
порекомендовав	VERB
свого	PRON
камарата	NOUN
із	PREP
band	X
of	X
joy	X
—	PUNKT
молодого	ADJ
джона	NAME
бонама	NAME
у	PREP
септембрї	NOUN
1968	NUM
року	NOUN
четвірка	NUM
провела	VERB
свої	PRON
першы	ADJ
репетіції	NOUN
у	PREP
лондоні	NAME
тогды	ADV
ся	PRON
іщі	ADV
ґрупа	NOUN
называла	VERB
«the	X
new	X
yardbirds».	X
свою	PRON
назву	NOUN
led	X
zeppelin	X
обтримав	VERB
з	PREP
легкой	ADJ
рукы	NOUN
джона	NAME
ентвілсла	VERB
із	PREP
the	X
who	X
іншы	PRON
твердять	VERB
же	PART
то	PART
быв	VERB
бубеник	NOUN
той	PRON
ґрупы	NOUN
кіт	NOUN
мун	NOUN
якось	ADV
він	ADV
пожартовав	VERB
же	PART
новый	ADJ
проєкт	NOUN
пейджа	ADV
полетить	VERB
як	CONJ
оловяна	ADJ
воздухолодь	NOUN
джіммі	NAME
не	PART
довго	ADV
думав	VERB
і	PREP
змінив	VERB
назву	VERB
на	PREP
«led	X
zeppelin».	X
літеру	NOUN
а	CONJ
одстранили	VERB
по	PREP
радї	ADV
менеджера	NOUN
ґрупы	NOUN
—	PUNTK
пітера	NAME
ґранта	NAME
—	PUNKT
кідь	ADV
по	PREP
його	PRON
словах	NOUN
тоты	ADV
тупы	ADJ
американці	NOUN
прочитають	VERB
назву	VERB
ґрупы	NOUN
як	CONJ
лід	NAME
зеппелін».	NAME
led	X
zeppelin	X
i	PREP
робота	NOUN
над	PREP
дебютним	ADJ
албумом	NOUN
ся	PRON
зачала	VERB
в	PREP
осени	NOUN
1968	NUM
року	NOUN
у	PREP
лондоньскім	ADJ
штудію	NOUN
"olimpic	X
studios".	X
ґрупа	NOUN
скомпоновала	VERB
пару	NUM
піснєй	NOUN
у	PREP
the	X
yardbirds:	X
«dazed	X
and	X
confused»	X
і	PREP
«how	X
many	X
more	X
times».	X
«babe,	X
i'm	X
gonna	X
leave	X
you»	X
за	PREP
пропозіціов	NOUN
роберта	NAME
планта	NAME
запожычали	VERB
у	PREP
джоан	NAME
баез.	NAME
тото	DEF
породило	VERB
масу	NOUN
пліток	NOUN
про	PREP
плаґіат	NOUN
пейджа,	NAME
але	CONJ
джіммі	NAME
быв	VERB
єдным	ADJ
з	PREP
авторів	NOUN
тых	PRON
пісень.	NOUN
одколи	ADV
ся	PRON
ґрупа	NOUN
розпала	VERB
то	PART
він	ADV
мав	ADV
повне	ADV
право	NOUN
включати	VERB
тоты	ADJ
композиції	NOUN
до	PREP
свого	PRON
репертоару	NOUN
окрем	VERB
тотых	ADV
пісень	NOUN
были	VERB
записаны	VERB
іщі	ADV
6	NUM
композіції	NOUN
якы	ADJ
были	VERB
написаны	VERB
під	PREP
час	NOUN
запису	NOUN
албум	NOUN
назвали	VERB
просто	ADV
—	PUNKT
led	X
zeppelin.	X
він	ADV
вышов	ADV
17	NUM
януара	NOUN
1969	NUM
року	NOUN
у	PREP
сша	NAME
а	CONJ
28	NUM
марца	NOUN
1969	NUM
у	PREP
великобританії.	NAME
scheme	X
є	PREP
мултіпарадіґматічный	ADJ
проґрамовачій	ADJ
язык	NOUN
фунціонална	NOUN
парадіґма	NOUN
належыть	VERB
міджі	NOUN
такзваны	ADV
декларатівны	ADJ
парадіґмата	NOUN
scheme	X
є	PREP
єден	NOUN
з	PREP
двох	NUM
головный	ADJ
діалектів	NOUN
функціоналного	ADJ
проґрамовачого	ADJ
языка	NOUN
lisp.	X
язык	NOUN
предложыли	VERB
гай	NAME
луіс	NAME
стіл	NAME
(guy	X
lewis	X
steele)	X
і	PREP
жералд	NAME
джей	NAME
сусман	NAME
(gerald	X
jay	X
sussman)	X
і	PREP
ёго	PRON
першый	ADJ
попис	NOUN
быв	VERB
списаный	ADJ
в	PREP
роцї	NOUN
1975.	NUM
scheme	X
быв	VERB
представленый	ADJ
академічному	ADJ
світу	NOUN
через	PREP
серію	NOUN
статей	NOUN
нынї	ADV
знамых	ADJ
як	CONJ
сусмановы	ADJ
і	PREP
стіловы	NOUN
ламбда	NOUN
папіря	NOUN
язык	NOUN
scheme	X
дефінують	NOUN
два	NUM
штандарты	NOUN
офіціалный	ADJ
ieee	X
штандарт	NOUN
і	PREP
штандарт	NOUN
званый	ADJ
revisedn	X
report	X
on	X
the	X
algorithmic	X
language	X
scheme,	X
скорочено	X
rnrs,	X
де	PREP
n	X
є	PREP
чісло	NOUN
ревізії	ADJ
сучасный	ADJ
штандарт	NOUN
є	PREP
r5rs,	X
і	PREP
r6rs	X
ся	PRON
вывивать	VERB
опроти	ADV
lisp-у	X
ся	PEON
scheme	X
снажыть	VERB
о	PREP
мінімалізм	NOUN
-	PUNKT
додати	NOUN
што	CONJ
найменше	ADJ
чісло	NOUN
основных	ADJ
функцій	NOUN
на	PREP
котрых	PRON
суть	NOUN
пак	NOUN
в	PREP
книжніцях	NOUN
поставлены	VERB
зложытїшы	ADJ
конштрукції	NOUN
вдяка	ADV
тому	PRON
має	VERB
дотеперь	ADV
послїдня	ADJ
референція	NOUN
языка	NOUN
лем	NOUN
50	NUM
сторінок	NOUN
scheme	X
быв	VERB
першым	ADJ
діалектом	NOUN
lisp-у,	X
котрый	ADJ
понукав	ADV
вольбу	ADV
міджі	ADV
лексікалным	ADJ
або	CONJ
дінамічным	ADJ
россягом	NOUN
платности	NOUN
переменной	NOUN
тыж	PART
быв	VERB
першым	ADJ
языком	NOUN
котрый	PRON
підпоровав	VERB
„first-class	X
continuation“.	X
