Zeppelin	Zeppelin
Зеппелін,	Зеппелин,
Zeppelin"	Zeppelin"
брітаньска	британьска
закладателїв	закладателев
років	роков
роспадї	роспаде
причіны	причины
Zeppelin	Zeppelin
оцїнюють	оценюють	
успіх	успех
і	и
міліонів	милионов
албумів	албумов
світї,	свете,
тім	тем
чіслї	числе	
міліонів	милионов	
їх	их
штудіёвы	штудиёвы	
компілаціями,	компилациями,
Billboard	Billboard	
Zeppelin	Zeppelin
найвызначнїшых	найвызначнїшых
Історія.	История.
послїднїм	последнем
розпадї	розпаде
Yardbirds»	Yardbirds»	
ґітаріста	ґитариста
Джіммі	Джимми
зложіня	зложиня
репутація	репутаця	
ґітарісту.	ґитаристу.
літї	лете
Джіммі	Джимми
іде	иде
Бірмінґема,	Бирминґема,	
і	и
вокалісту	вокалисту	
